# 0 = EMPTY
# 1 = WALL
# 2 = GHOST_WALL
# 3 = GHOST_GATE
# 4 = BORDER
# 5 = PACDOT
# 6 = FRUIT
# 7 = PAC_STARTUP
# 8 = BLINKY_STARTUP
# 9 = GHOSTS_STARTUP
# [a-z] = Teleporter
4 4 4 4 4 4 4 4 4 4 4 4 4 4 4 4 4 4 4 4 4 4 4 4 4 4 4 4
4 5 5 5 5 5 5 5 5 5 5 5 5 4 4 5 5 5 5 5 5 5 5 5 5 5 5 4
4 5 1 1 1 1 5 1 1 1 1 1 5 4 4 5 1 1 1 1 1 5 1 1 1 1 5 4
4 6 1 1 1 1 5 1 1 1 1 1 5 4 4 5 1 1 1 1 1 5 1 1 1 1 6 4
4 5 1 1 1 1 5 1 1 1 1 1 5 4 4 5 1 1 1 1 1 5 1 1 1 1 5 4
4 5 5 5 5 5 5 5 5 5 5 5 5 5 5 5 5 5 5 5 5 5 5 5 5 5 5 4
4 5 1 1 1 1 5 1 1 5 1 1 1 1 1 1 1 1 5 1 1 5 1 1 1 1 5 4
4 5 1 1 1 1 5 1 1 5 1 1 1 1 1 1 1 1 5 1 1 5 1 1 1 1 5 4
4 5 5 5 5 5 5 1 1 5 5 5 5 1 1 5 5 5 5 1 1 5 5 5 5 5 5 4
4 4 4 4 4 4 5 1 1 1 1 1 5 1 1 5 1 1 1 1 1 5 4 4 4 4 4 4
0 0 0 0 0 4 5 1 1 1 1 1 5 1 1 5 1 1 1 1 1 5 4 0 0 0 0 0
0 0 0 0 0 4 5 1 1 5 5 5 5 8 0 5 5 5 5 1 1 5 4 0 0 0 0 0
0 0 0 0 0 4 5 1 1 5 2 2 3 3 3 3 2 2 5 1 1 5 4 0 0 0 0 0
4 4 4 4 4 4 5 1 1 5 2 9 9 9 9 9 9 2 5 1 1 5 4 4 4 4 4 4
a 5 5 5 5 5 5 5 5 5 2 9 9 9 9 9 9 2 5 5 5 5 5 5 5 5 5 a
4 4 4 4 4 4 5 1 1 5 2 9 9 9 9 9 9 2 5 1 1 5 4 4 4 4 4 4
0 0 0 0 0 4 5 1 1 5 2 2 2 2 2 2 2 2 5 1 1 5 4 0 0 0 0 0
0 0 0 0 0 4 5 1 1 5 5 5 5 5 5 5 5 5 5 1 1 5 4 0 0 0 0 0
0 0 0 0 0 4 5 1 1 5 1 1 1 1 1 1 1 1 5 1 1 5 4 0 0 0 0 0
4 4 4 4 4 4 5 1 1 5 1 1 1 1 1 1 1 1 5 1 1 5 4 4 4 4 4 4
4 5 5 5 5 5 5 5 5 5 5 5 5 1 1 5 5 5 5 5 5 5 5 5 5 5 5 4
4 5 1 1 1 1 5 1 1 1 1 1 5 1 1 5 1 1 1 1 1 5 1 1 1 1 5 4
4 5 1 1 1 1 5 1 1 1 1 1 5 1 1 5 1 1 1 1 1 5 1 1 1 1 5 4
4 6 5 5 1 1 5 5 5 5 5 5 5 5 5 5 5 5 5 5 5 5 1 1 5 5 6 4
4 4 4 5 1 1 5 1 1 5 1 1 1 1 1 1 1 1 5 1 1 5 1 1 5 4 4 4
4 4 4 5 1 1 5 1 1 5 1 1 1 1 1 1 1 1 5 1 1 5 1 1 5 4 4 4
4 5 5 5 5 5 5 1 1 5 5 5 5 1 1 5 5 5 5 1 1 5 5 5 5 5 5 4
4 5 1 1 1 1 1 1 1 1 1 1 5 1 1 5 1 1 1 1 1 1 1 1 1 1 5 4
4 5 1 1 1 1 1 1 1 1 1 1 5 1 1 5 1 1 1 1 1 1 1 1 1 1 5 4
4 5 5 5 5 5 5 5 5 5 5 5 5 5 5 5 5 5 5 5 5 5 5 5 5 5 7 4
4 4 4 4 4 4 4 4 4 4 4 4 4 4 4 4 4 4 4 4 4 4 4 4 4 4 4 4