# 0 = EMPTY
# 1 = WALL
# 2 = GHOST_WALL
# 3 = GHOST_GATE
# 4 = BORDER
# 5 = PACDOT
# 6 = FRUIT
# 7 = PAC_STARTUP
# 8 = BLINKY_STARTUP
# 9 = GHOSTS_STARTUP
# [a-z] = Teleporter
4 4 4 4 4 4 4 4 4 4 4 4 4 4 4 4 4 4 4 4 4 4 4 4 4 4 4 4
4 0 0 0 0 0 0 0 0 0 0 0 0 4 4 0 0 0 0 0 0 0 0 0 0 0 0 4
4 0 1 1 1 1 0 1 1 1 1 1 0 4 4 0 1 1 1 1 1 0 1 1 1 1 0 4
4 0 1 1 1 1 0 1 1 1 1 1 0 4 4 0 1 1 1 1 1 0 1 1 1 1 0 4
4 0 1 1 1 1 0 1 1 1 1 1 0 4 4 0 1 1 1 1 1 0 1 1 1 1 0 4
4 0 0 0 0 0 0 0 0 0 0 0 0 0 0 0 0 0 0 0 0 0 0 0 0 0 0 4
4 0 1 1 1 1 0 1 1 0 1 1 1 1 1 1 1 1 0 1 1 0 1 1 1 1 0 4
4 0 1 1 1 1 0 1 1 0 1 1 1 1 1 1 1 1 0 1 1 0 1 1 1 1 0 4
4 0 0 0 0 0 0 1 1 0 0 0 0 1 1 0 0 0 0 1 1 0 0 0 0 0 0 4
4 4 4 4 4 4 0 1 1 1 1 1 0 1 1 0 1 1 1 1 1 0 4 4 4 4 4 4
0 0 0 0 0 4 0 1 1 1 1 1 0 1 1 0 1 1 1 1 1 0 4 0 0 0 0 0
0 0 0 0 0 4 0 1 1 0 0 0 0 8 0 0 0 0 0 1 1 0 4 0 0 0 0 0
0 0 0 0 0 4 0 1 1 0 2 2 3 3 3 3 2 2 0 1 1 0 4 0 0 0 0 0
4 4 4 4 4 4 0 1 1 0 2 9 9 9 9 9 9 2 0 1 1 0 4 4 4 4 4 4
a 0 0 0 0 0 0 0 0 0 2 9 9 9 9 9 9 2 0 0 0 0 0 0 0 0 0 a
4 4 4 4 4 4 0 1 1 0 2 9 9 9 9 9 9 2 0 1 1 0 4 4 4 4 4 4
0 0 0 0 0 4 0 1 1 0 2 2 2 2 2 2 2 2 0 1 1 0 4 0 0 0 0 0
0 0 0 0 0 4 0 1 1 0 0 0 0 0 0 0 0 0 0 1 1 0 4 0 0 0 0 0
0 0 0 0 0 4 0 1 1 0 1 1 1 1 1 1 1 1 0 1 1 0 4 0 0 0 0 0
4 4 4 4 4 4 0 1 1 0 1 1 1 1 1 1 1 1 0 1 1 0 4 4 4 4 4 4
4 0 0 0 0 0 0 0 0 0 0 0 0 1 1 0 0 0 0 0 0 0 0 0 0 0 0 4
4 0 1 1 1 1 0 1 1 1 1 1 0 1 1 0 1 1 1 1 1 0 1 1 1 1 0 4
4 0 1 1 1 1 0 1 1 1 1 1 0 1 1 0 1 1 1 1 1 0 1 1 1 1 0 4
4 0 0 0 1 1 0 0 0 0 0 0 0 0 0 0 0 0 0 0 0 0 1 1 0 0 6 4
4 4 4 0 1 1 0 1 1 0 1 1 1 1 1 1 1 1 0 1 1 0 1 1 0 4 4 4
4 4 4 0 1 1 0 1 1 0 1 1 1 1 1 1 1 1 0 1 1 0 1 1 0 4 4 4
4 0 0 0 0 0 0 1 1 0 0 0 0 1 1 0 0 0 0 1 1 0 0 0 0 0 0 4
4 0 1 1 1 1 1 1 1 1 1 1 0 1 1 0 1 1 1 1 1 1 1 1 1 1 0 4
4 0 1 1 1 1 1 1 1 1 1 1 0 1 1 0 1 1 1 1 1 1 1 1 1 1 0 4
4 0 0 0 0 5 5 0 0 0 0 0 0 0 0 0 0 0 0 0 0 0 0 0 0 0 7 4
4 4 4 4 4 4 4 4 4 4 4 4 4 4 4 4 4 4 4 4 4 4 4 4 4 4 4 4